........................................
........................................
........................................
........................................
........................................
........................................
........................................
........#######.........................
........#.....#.........................
........#.....#.........................
........#.....#.........................
..#######.....#.........................
..#.....#.....#.........................
..#...###.....#.........................
..#.....#.....#.........................
..#...........#.........................
..#...........#.........................
..#..####.....#.........................
..#..#..#.....#.........................
..#..#..#.....#.........................
..#..#........#.........................
..#..#........#.........................
..#..##########.........................
..#...........#.........................
..########....#.........................
..............#.........................
.......###..###.........................
.......#.####...........................
........................................
........................................
........................................
........................................
........................................
........................................
........................................
........................................
........................................
........................................
........................................
.......................................#
